Checking for undescribed rooms:
Terminal B-0 has no description.
Terminal B-1 has no description.
Terminal B-3 has no description.
Terminal B-4 has no description.
Terminal B-5 has no description.
Terminal B-6 has no description.
Terminal B-7 has no description.
Road DR 1-1 has no description.
Road DR 1-2 has no description.
Data Repository DR-1 has no description.
Data Repository DR 2 has no description.
Road DR 2-1 has no description.
Road RP-1 has no description.
Road RP-2 has no description.
Power Plant Vicinity PP-1 has no description.
Power Plant Entrance PP-2 has no description.
Power Plant Core PPC-1 has no description.
Road C-1 has no description.
Road C-2 has no description.
City Grid CG-1 has no description.
Virus Lab Security Checkpoint VL-1 has no description.
Virus Lab Central Hub VL-2 has no description.
Genesis Path GP-1 has no description.
Genesis Access GA-1 has no description.
Genesis Overlook has no description.
AI Core has no description.
Internal System IS-1 has no description.
Internal System IS-2 has no description.
Internal System IS-3 has no description.
Internal System IS-4 has no description.
Antivirus Coprocessor has no description.

Checking for undescribed objects:
exit terminal has no description.
your body has no description.
cube has no description.
tubes has no description.
computer terminal has no description.
hole has no description.
floor has no description.
walls has no description.
ceiling has no description.
Door BT-1 has no description.
rubble has no description.
south wall has no description.
hovertank has no description.
gun barrel has no description.
northward door has no description.
Security Door RP has no description.
Power Plant Hatch PPH-1 has no description.

Source Is Soul
An Interactive Fiction by Kevin Cameron, Casey Scheide
Release 1 / Serial number 130310 / Inform 7 build 6G60 (I6/v6.32 lib 6/12N) SD

Silicon Expanse
You are in a thousand places at once. Tiny parts of you flicker on and off at the edge of your perception. Signals and data flow in and out of you.
(

>s
Terminal B-0

(

>w
You can't go that way.

[From here, you can go north and east.]

>e
Terminal B-1

>sw
Terminal B-3

>s
Terminal B-6

>s
You can't go that way.

[From here, you can go north and west.]

>take terminal
Absolute darkness and silence fall around you. For a fleeting moment, you experience nothing whatsoever. 

 A single line of white text blinks into view, hovering motionless in the black void. 

 …initiating startup sequence…　 

 Somewhere far away, yet somehow closing in, a motor springs to life. Warmth flows over you, spreading outwards from below. You feel your head suddenly spring into existence behind your eyes, followed closely by your torso, arms, and legs.

(press any key to continue)

Birth Server Terminus
A large metallic cube rests dead center in a small room, enclosed by smooth, dark walls. Thick tubes snake out from the base of the cube, disappearing into the floor in all directions. Harsh sunlight spills through a jagged hole in the ceiling, illuminating the area and casting an eerie glow over the door to the east. A small computer terminal juts up from the floor to the side of the cube.
You can see Door BT-1 here.

* * *

>s
Terminal B-0

(

>e
Terminal B-1

(

>sw
Terminal B-3

(

>s
Terminal B-6

(

>take terminal
Absolute darkness and silence fall around you. For a fleeting moment, you experience nothing whatsoever. 

 A single line of white text blinks into view, hovering motionless in the black void. 

 …initiating startup sequence…　 

 Somewhere far away, yet somehow closing in, a motor springs to life. Warmth flows over you, spreading outwards from below. You feel your head suddenly spring into existence behind your eyes, followed closely by your torso, arms, and legs.

(press any key to continue)

>[enter]
Birth Server Terminus
A large metallic cube rests dead center in a small room, enclosed by smooth, dark walls. Thick tubes snake out from the base of the cube, disappearing into the floor in all directions. Harsh sunlight spills through a jagged hole in the ceiling, illuminating the area and casting an eerie glow over the door to the east. A small computer terminal juts up from the floor to the side of the cube.
You can see Door BT-1 here.

>enter body
Birth Server Terminus (in your body)
A large metallic cube rests dead center in a small room, enclosed by smooth, dark walls. Thick tubes snake out from the base of the cube, disappearing into the floor in all directions. Harsh sunlight spills through a jagged hole in the ceiling, illuminating the area and casting an eerie glow over the door to the east. A small computer terminal juts up from the floor to the side of the cube.
You can see Door BT-1 here.

>exit body
[But you aren't on your body at the moment.]

>i
You are carrying nothing.

>exit
Birth Server Terminus
A large metallic cube rests dead center in a small room, enclosed by smooth, dark walls. Thick tubes snake out from the base of the cube, disappearing into the floor in all directions. Harsh sunlight spills through a jagged hole in the ceiling, illuminating the area and casting an eerie glow over the door to the east. A small computer terminal juts up from the floor to the side of the cube.
You can see your body and Door BT-1 here.

>take body
[You already have that.]

>i
You are carrying:
  your body

* * *

>s
Terminal B-6

(

>examine terminal
Terminal B-6

You can see exit terminal here.

>take terminal
Absolute darkness and silence fall around you. For a fleeting moment, you experience nothing whatsoever. 

 A single line of white text blinks into view, hovering motionless in the black void. 

 …initiating startup sequence…　 

 Somewhere far away, yet somehow closing in, a motor springs to life. Warmth flows over you, spreading outwards from below. You feel your head suddenly spring into existence behind your eyes, followed closely by your torso, arms, and legs.

(press any key to continue)

* * *

>s
Terminal B-6

(

>s
Absolute darkness and silence fall around you. For a fleeting moment, you experience nothing whatsoever. 

 A single line of white text blinks into view, hovering motionless in the black void. 

 Initializing startup sequence.

(press any key to continue)

>take terminal
Absolute darkness and silence fall around you. For a fleeting moment, you experience nothing whatsoever. 

 A single line of white text blinks into view, hovering motionless in the black void. 

 …initiating startup sequence…　 

 Somewhere far away, yet somehow closing in, a motor springs to life. Warmth flows over you, spreading outwards from below. You feel your head suddenly spring into existence behind your eyes, followed closely by your torso, arms, and legs.

(press any key to continue)

>w
You can't go that way.

[The only way to go is east.]

>e
(first opening Door BT-1)

Road SR-1
The ruins of what was once a long, enclosed hallway extend before you. The ceiling has almost entirely collapsed, littering the floor with rubble. The center of the south wall has been smashed inward, revealing the front half of a long-since disabled hovertank. The main gun barrel of the damaged tank extends across the hallway, and appears to have collided with the northward door, ripping it from its frame. Doors stand to the east and west.
You can see Door BT-1 here.

>n
Road DR 1-1

>w
Road DR 1-2

>s
Data Repository DR-1

>n
Road DR 1-2

>e
Road DR 1-1

>s
Road SR-1
The ruins of what was once a long, enclosed hallway extend before you. The ceiling has almost entirely collapsed, littering the floor with rubble. The center of the south wall has been smashed inward, revealing the front half of a long-since disabled hovertank. The main gun barrel of the damaged tank extends across the hallway, and appears to have collided with the northward door, ripping it from its frame. Doors stand to the east and west.
You can see Door BT-1 here.

>e
Road SR-2
An ancient foyer forms a well-worn crossroads, with paths leading in all cardinal directions.
You can see Security Door RP here.

>e
Road C-1

>n
You can't go that way.

[From here, you can go east and west.]

>w
Road SR-2
An ancient foyer forms a well-worn crossroads, with paths leading in all cardinal directions.
You can see Security Door RP here.

>n
Refuge R-1

>e
You can't go that way.

[The only way to go is south.]

>s
Road SR-2
An ancient foyer forms a well-worn crossroads, with paths leading in all cardinal directions.
You can see Security Door RP here.

>s
(first opening Security Door RP)
It seems to be locked.

>LOOK
Road SR-2
An ancient foyer forms a well-worn crossroads, with paths leading in all cardinal directions.
You can see Security Door RP here.

>LOOK
Road SR-2
An ancient foyer forms a well-worn crossroads, with paths leading in all cardinal directions.
You can see Security Door RP here.

>e
Road C-1

>e
Road C-2

>w
Road C-1

>w
Road SR-2
An ancient foyer forms a well-worn crossroads, with paths leading in all cardinal directions.
You can see Security Door RP here.

* * *

>take terminal
Absolute darkness and silence fall around you. For a fleeting moment, you experience nothing whatsoever. 

 A single line of white text blinks into view, hovering motionless in the black void. 

 …initiating startup sequence…　 

 Somewhere far away, yet somehow closing in, a motor springs to life. Warmth flows over you, spreading outwards from below. You feel your head suddenly spring into existence behind your eyes, followed closely by your torso, arms, and legs.

(press any key to continue)

>showme self
yourself - person
    your body
        Observation module (part of your body) - module
        Examination module (part of your body) - module
location: in Birth Server Terminus
singular-named, proper-named; unlit, inedible, portable, ordinarily enumerated, seen, unfamiliar; male, staid
printed name: "yourself"
printed plural name: "people"
indefinite article: none
corrupted description: You cannot escape.

description: "Physical Diagnostic:"
initial appearance: none
disambiguation id: 0
remembered location: Birth Server Terminus
carrying capacity: 100
path so far: 
described motion:

* * *

Birth Server Terminus
A large metallic cube rests dead center in a small room, enclosed by smooth, dark walls. Thick tubes snake out from the base of the cube, disappearing into the floor in all directions. Harsh sunlight spills through a jagged hole in the ceiling, illuminating the area and casting an eerie glow over the door to the east. A small computer terminal juts up from the floor to the side of the cube.
You can see Door BT-1 here.

>enter body
[That's not something you can enter.]

>rules on
Rules tracing now switched on. Type "rules off" to switch it off again, or "rules all" to include even rules which do not apply.

>enter body
[Rule "convert enter door into go rule" applies.]
[Rule "convert enter compass direction into go rule" applies.]
[Rule "can't enter what's already entered rule" applies.]
[Rule "can't enter what's not enterable rule" applies.]
[That's not something you can enter.]

>i
[Rule "print empty inventory rule" applies.]
[Rule "print standard inventory rule" applies.]
You are carrying:
  your body

[Rule "report other people taking inventory rule" applies.]

* * *

>s
Absolute darkness and silence fall around you. For a fleeting moment, you experience nothing whatsoever. 

 A single line of white text blinks into view, hovering motionless in the black void. 

 Initializing startup sequence.

(press any key to continue)

Birth Server Terminus
A large metallic cube rests dead center in a small room, enclosed by smooth, dark walls. Thick tubes snake out from the base of the cube, disappearing into the floor in all directions. Harsh sunlight spills through a jagged hole in the ceiling, illuminating the area and casting an eerie glow over the door to the east. A small computer terminal juts up from the floor to the side of the cube.
You can see Door BT-1 here.

>i
You are carrying:
  your body

>x body
You see nothing unexpected about your body.

>x module
[Which do you mean, 1) Observation module or 2) Examination module?]

>1
(Observation module)
Observation module capacity: optimal.

* * *

Birth Server Terminus
A large metallic cube rests dead center in a small room, enclosed by smooth, dark walls. Thick tubes snake out from the base of the cube, disappearing into the floor in all directions. Harsh sunlight spills through a jagged hole in the ceiling, illuminating the area and casting an eerie glow over the door to the east. A small computer terminal juts up from the floor to the side of the cube.
You can see Door BT-1 here.

>LOOK
Birth Server Terminus
A large metallic cube rests dead center in a small room, enclosed by smooth, dark walls. Thick tubes snake out from the base of the cube, disappearing into the floor in all directions. Harsh sunlight spills through a jagged hole in the ceiling, illuminating the area and casting an eerie glow over the door to the east. A small computer terminal juts up from the floor to the side of the cube.
You can see Door BT-1 here.

>e
(first opening Door BT-1)

Road SR-1
The ruins of what was once a long, enclosed hallway extend before you. The ceiling has almost entirely collapsed, littering the floor with rubble. The center of the south wall has been smashed inward, revealing the front half of a long-since disabled hovertank. The main gun barrel of the damaged tank extends across the hallway, and appears to have collided with the northward door, ripping it from its frame. Doors stand to the east and west.
You can see Door BT-1 here.

>e
Road SR-2
An ancient foyer forms a well-worn crossroads, with paths leading in all cardinal directions.
You can see Security Door RP here.

>n
Refuge R-1
You stand in a large room, surrounded by heavily-armored walls. Orange holographic letters float in a tight circle over the center of the area, displaying the message "Welcome Home". An energy shield covers the area, distorting your view of the sky. One corner of the refuge contains several universal charging stations and an AMS-5 repair node.

>x shield
A pale gold energy shield that keeps out the elements as well as forcing any intruders to first go through the main gate. You detect rows of primary and backup projectors that occasionally cycle on-and-off.

>x stations
Simple power receptacles with a variety of connectors for different robot makes. You spot one that corresponds with your own power supply.

>x repair
A large red box containing various power tools and fabrication systems. Used for repairing physical damage to robot systems.

>s
Road SR-2
An ancient foyer forms a well-worn crossroads, with paths leading in all cardinal directions.
You can see Security Door RP here.

* * *

>s
Absolute darkness and silence fall around you. For a fleeting moment, you experience nothing whatsoever. 

 A single line of white text blinks into view, hovering motionless in the black void. 

 Initializing startup sequence.

(press any key to continue)

Observation module...done.

Examination module...done.

 

 Somewhere far away, yet somehow closing in, a motor springs to life. Warmth flows over you, spreading outwards from below. You feel your head suddenly spring into existence behind your eyes, followed closely by your torso, arms, and legs.

(press any key to continue)

>e
(first opening Door BT-1)

Road SR-1
The ruins of what was once a long, enclosed hallway extend before you. The ceiling has almost entirely collapsed, littering the floor with rubble. The center of the south wall has been smashed inward, revealing the front half of a long-since disabled hovertank. The main gun barrel of the damaged tank extends across the hallway, and appears to have collided with the northward door, ripping it from its frame. Doors stand to the east and west.
You can see Door BT-1 here.

* * *

Observation module...done.

Examination module...done.

 

 Somewhere far away, yet somehow closing in, a motor springs to life. Warmth flows over you, spreading outwards from below. You feel your head suddenly spring into existence behind your eyes, followed closely by your torso, arms, and legs.

(press any key to continue)

>s
You can't go that way.

[The only way to go is east.]

>e
(first opening Door BT-1)

Road SR-1
The ruins of what was once a long, enclosed hallway extend before you. The ceiling has almost entirely collapsed, littering the floor with rubble. The center of the south wall has been smashed inward, revealing the front half of a long-since disabled hovertank. The main gun barrel of the damaged tank extends across the hallway, and appears to have collided with the northward door, ripping it from its frame. Doors stand to the east and west.
You can see Door BT-1 here.

* * *

>w
Road SR-2
An ancient foyer forms a well-worn crossroads, with paths leading in all cardinal directions.
You can see Security Door RP here.

>n
Refuge R-1
You stand in a large room, surrounded by heavily-armored walls. Orange holographic letters float in a tight circle over the center of the area, displaying the message "Welcome Home". An energy shield covers the area, distorting your view of the sky. One corner of the refuge contains several universal charging stations and an AMS-5 repair node.

>e
Refuge Art Gallery
A small room with several constructs elevated on metal crates as exhibits.

>x exhibits
Among the exhibits you find a strangely shaped gear, a complex set of gears and chains arranged in a box, and a number of carvings and paintings depicting various data structures and their contents.

>x gears
[I didn't recognise all of the words in that command.]

>x gear set
You notice on closer inspection that each of the gears on the construct are tightly connected, and that a set of rods protruding from the side would allow you to change which ones connect to the other. The display beneath the exhibit transmits a low signal: (transmission (gear (64))).

* * *

Observation module...done.

Examination module...done.

 

 Somewhere far away, yet somehow closing in, a motor springs to life. Warmth flows over you, spreading outwards from below. You feel your head suddenly spring into existence behind your eyes, followed closely by your torso, arms, and legs.

(press any key to continue)

Birth Server Terminus
A large metallic cube rests dead center in a small room, enclosed by smooth, dark walls. Thick tubes snake out from the base of the cube, disappearing into the floor in all directions. Harsh sunlight spills through a jagged hole in the ceiling, illuminating the area and casting an eerie glow over the door to the east. A small computer terminal juts up from the floor to the side of the cube.
You can see Door BT-1 here.

(

>w
You can't go that way.

[The only way to go is east.]

(

>e
(first opening Door BT-1)

Road SR-1
The ruins of what was once a long, enclosed hallway extend before you. The ceiling has almost entirely collapsed, littering the floor with rubble. The center of the south wall has been smashed inward, revealing the front half of a long-since disabled hovertank. The main gun barrel of the damaged tank extends across the hallway, and appears to have collided with the northward door, ripping it from its frame. Doors stand to the east and west.
You can see Door BT-1 here.

(

* * *

Birth Server Terminus
A large metallic cube rests dead center in a small room, enclosed by smooth, dark walls. Thick tubes snake out from the base of the cube, disappearing into the floor in all directions. Harsh sunlight spills through a jagged hole in the ceiling, illuminating the area and casting an eerie glow over the door to the east. A small computer terminal juts up from the floor to the side of the cube.
You can see Door BT-1 here.

(

>x self
Physical Diagnostic:

(

>e
(first opening Door BT-1)

Road SR-1
The ruins of what was once a long, enclosed hallway extend before you. The ceiling has almost entirely collapsed, littering the floor with rubble. The center of the south wall has been smashed inward, revealing the front half of a long-since disabled hovertank. The main gun barrel of the damaged tank extends across the hallway, and appears to have collided with the northward door, ripping it from its frame. Doors stand to the east and west.
You can see Door BT-1 here.

(

>e
Road SR-2
An ancient foyer forms a well-worn crossroads, with paths leading in all cardinal directions.
You can see Security Door RP here.

(

>n
Refuge R-1
You stand in a large room, surrounded by heavily-armored walls. Orange holographic letters float in a tight circle over the center of the area, displaying the message "Welcome Home". An energy shield covers the area, distorting your view of the sky. One corner of the refuge contains several universal charging stations and an AMS-5 repair node.
(

>e
Refuge Art Gallery
A small room with several constructs elevated on metal crates as exhibits.
(

>x exhibits
Among the exhibits you find a strangely shaped gear, a complex set of gears and chains arranged in a box, and a number of carvings and paintings depicting various data structures and their contents.

(

>x gear
[Which do you mean, the 1) complex gear set or the 2) strangely shaped gear?]

(

>1
(the complex gear set)
You notice on closer inspection that each of the gears on the construct are tightly connected, and that a set of rods protruding from the side would allow you to change which ones connect to the other. The display beneath the exhibit transmits a low signal: (transmission (gear (64))).

(

>x nautilus)
The gear's teeth form a counter clockwise spiral from the center outwards, with square teeth on the outside and triangular teeth on the inside. Geometric analysis indicates that each of the triangular teeth is almost perfectly equilateral. The display beneath the exhibit transmits a low signal: (nautilus).

(

>w
Refuge R-1
You stand in a large room, surrounded by heavily-armored walls. Orange holographic letters float in a tight circle over the center of the area, displaying the message "Welcome Home". An energy shield covers the area, distorting your view of the sky. One corner of the refuge contains several universal charging stations and an AMS-5 repair node.
(

>s
Road SR-2
An ancient foyer forms a well-worn crossroads, with paths leading in all cardinal directions.
You can see Security Door RP here.

(

>w
Road SR-1
The ruins of what was once a long, enclosed hallway extend before you. The ceiling has almost entirely collapsed, littering the floor with rubble. The center of the south wall has been smashed inward, revealing the front half of a long-since disabled hovertank. The main gun barrel of the damaged tank extends across the hallway, and appears to have collided with the northward door, ripping it from its frame. Doors stand to the east and west.
You can see Door BT-1 here.

(

>w
Birth Server Terminus
A large metallic cube rests dead center in a small room, enclosed by smooth, dark walls. Thick tubes snake out from the base of the cube, disappearing into the floor in all directions. Harsh sunlight spills through a jagged hole in the ceiling, illuminating the area and casting an eerie glow over the door to the east. A small computer terminal juts up from the floor to the side of the cube.
You can see Door BT-1 here.

(

>e
Road SR-1
The ruins of what was once a long, enclosed hallway extend before you. The ceiling has almost entirely collapsed, littering the floor with rubble. The center of the south wall has been smashed inward, revealing the front half of a long-since disabled hovertank. The main gun barrel of the damaged tank extends across the hallway, and appears to have collided with the northward door, ripping it from its frame. Doors stand to the east and west.
You can see Door BT-1 here.

(

>n
Road DR 1-1

(

>w
Road DR 1-2

(

>s
Data Repository DR-1

(

>n
Road DR 1-2

(

>e
Road DR 1-1

(

>s
Road SR-1
The ruins of what was once a long, enclosed hallway extend before you. The ceiling has almost entirely collapsed, littering the floor with rubble. The center of the south wall has been smashed inward, revealing the front half of a long-since disabled hovertank. The main gun barrel of the damaged tank extends across the hallway, and appears to have collided with the northward door, ripping it from its frame. Doors stand to the east and west.
You can see Door BT-1 here.

(

* * *

>s
Terminal B-6

(

>take teminal
[You don't need to use the word "teminal" in that way.]

>take
(exit terminal)
Absolute darkness and silence fall around you. For a fleeting moment, you experience nothing whatsoever. 

 A single line of white text blinks into view, hovering motionless in the black void. 

 …initiating startup sequence…　 

 Somewhere far away, yet somehow closing in, a motor springs to life. Warmth flows over you, spreading outwards from below. You feel your head suddenly spring into existence behind your eyes, followed closely by your torso, arms, and legs.

(press any key to continue)

Birth Server Terminus
A large metallic cube rests dead center in a small room, enclosed by smooth, dark walls. Thick tubes snake out from the base of the cube, disappearing into the floor in all directions. Harsh sunlight spills through a jagged hole in the ceiling, illuminating the area and casting an eerie glow over the door to the east. A small computer terminal juts up from the floor to the side of the cube.
You can see Door BT-1 here.

>x self
You will:

>x self
You will:

* * *

>s
Terminal B-6

(

>e
You can't go that way.

[From here, you can go north and west.]

>n
Terminal B-3

>s
Terminal B-6

>s
Absolute darkness and silence fall around you. For a fleeting moment, you experience nothing whatsoever. 

 A single line of white text blinks into view, hovering motionless in the black void. 

 …initiating startup sequence… 

 Somewhere far away, yet somehow closing in, a motor springs to life. Warmth flows over you, spreading outwards from below. You feel your head suddenly spring into existence behind your eyes, followed closely by your torso, arms, and legs.

(press any key to continue)

Birth Server Terminus
A large metallic cube rests dead center in a small room, enclosed by smooth, dark walls. Thick tubes snake out from the base of the cube, disappearing into the floor in all directions. Harsh sunlight spills through a jagged hole in the ceiling, illuminating the area and casting an eerie glow over the door to the east. A small computer terminal juts up from the floor to the side of the cube.
You can see Door BT-1 here.

>s
You can't go that way.

[The only way to go is east.]

* * *

>x exhibits
Among the exhibits you find a strangely shaped gear, a complex set of gears and chains arranged in a box, and a number of carvings and paintings depicting various data structures and their contents.

>x gear
[Which do you mean, the 1) complex gear set or the 2) strangely shaped gear?]

>1
(the complex gear set)
You notice on closer inspection that each of the gears on the construct are tightly connected, and that a set of rods protruding from the side would allow you to change which ones connect to the other. The display beneath the exhibit transmits a low signal: (transmission (gear (64))).

>x gears
You notice on closer inspection that each of the gears on the construct are tightly connected, and that a set of rods protruding from the side would allow you to change which ones connect to the other. The display beneath the exhibit transmits a low signal: (transmission (gear (64))).

>x 64
[That's not something you can see now, or I misunderstood you.]

>x 64 gear transmission
You notice on closer inspection that each of the gears on the construct are tightly connected, and that a set of rods protruding from the side would allow you to change which ones connect to the other. The display beneath the exhibit transmits a low signal: (transmission (gear (64))).

>x graphs
You recognize one of the graphs as a multidimensional hash table. A horizontal line of nodes in the center indicate the initial table, with labeled branching lines to each of the secondary nodes.

>x data
[That's not something you can see now, or I misunderstood you.]

>w
Refuge R-1
You stand in a large room, surrounded by heavily-armored walls. Orange holographic letters float in a tight circle over the center of the area, displaying the message "Welcome Home". An energy shield covers the area, distorting your view of the sky. One corner of the refuge contains several universal charging stations and an AMS-5 repair node.

>s
Road SR-2
An ancient foyer forms a well-worn crossroads, with paths leading in all cardinal directions.
You can see Security Door RP here.

* * *

>e
Terminal B-1

(

>se
You can't go that way.

[From here, you can go southwest and west.]

>sw
Terminal B-3

>s
Terminal B-6

You can see player's terminal here.

>s
You can't go that way.

[From here, you can go north and west.]

>access terminal
[That's not a verb I recognise.]

>take terminal
Birth Server Terminus
A large metallic cube rests dead center in a small room, enclosed by smooth, dark walls. Thick tubes snake out from the base of the cube, disappearing into the floor in all directions. Harsh sunlight spills through a jagged hole in the ceiling, illuminating the area and casting an eerie glow over the door to the east. A small computer terminal juts up from the floor to the side of the cube.
You can see Door BT-1 here.

Absolute darkness and silence fall around you. For a fleeting moment, you experience nothing whatsoever. 

 A single line of white text blinks into view, hovering motionless in the black void. 

 …initiating startup sequence…　 

 Somewhere far away, a motor springs to life. Warmth flows over you, spreading outwards from below. You feel your head suddenly spring into existence behind your eyes, followed closely by your torso, arms, and legs.

* * *

>e
Terminal B-1

(

>s
You can't go that way.

[From here, you can go southwest and west.]

>sw
Terminal B-3

* * *

>s
Terminal B-6

>s
Absolute darkness and silence fall around you. For a fleeting moment, you experience nothing whatsoever. 

 A single line of white text blinks into view, hovering motionless in the black void. 

 exit terminal capacity: 
*** Run-time problem P47 (at paragraph 1 in the source text): Phrase applied to an incompatible kind of value.

.
exit terminal capacity: .
 

 Somewhere far away, yet somehow closing in, a motor springs to life. Warmth flows over you, spreading outwards from below. You feel your head suddenly spring into existence behind your eyes, followed closely by your torso, arms, and legs.

(press any key to continue)

* * *

>s
Terminal B-0

(

>se
You can't go that way.

[From here, you can go north and east.]

>e
Terminal B-1

* * *

>s
You can't go that way.

[From here, you can go north and west.]

>take terminal
Birth Server Terminus
A large metallic cube rests dead center in a small room, enclosed by smooth, dark walls. Thick tubes snake out from the base of the cube, disappearing into the floor in all directions. Harsh sunlight spills through a jagged hole in the ceiling, illuminating the area and casting an eerie glow over the door to the east. A small computer terminal juts up from the floor to the side of the cube.
You can see Door BT-1 here.

Absolute darkness and silence fall around you. For a fleeting moment, you experience nothing whatsoever. 

 A single line of white text blinks into view, hovering motionless in the black void. 

 …initiating startup sequence…　 

 Somewhere far away, a motor springs to life. Warmth flows over you, spreading outwards from below. You feel your head suddenly spring into existence behind your eyes, followed closely by your torso, arms, and legs.

* * *

>s
Terminal B-0

(

>s
You can't go that way.

[From here, you can go north and east.]

>e
Terminal B-1

* * *

>s
Absolute darkness and silence fall around you. For a fleeting moment, you experience nothing whatsoever. 

 A single line of white text blinks into view, hovering motionless in the black void. 

 …initiating startup sequence… 

 Somewhere far away, yet somehow closing in, a motor springs to life. Warmth flows over you, spreading outwards from below. You feel your head suddenly spring into existence behind your eyes, followed closely by your torso, arms, and legs.

(press any key to continue)

>take terminal
Absolute darkness and silence fall around you. For a fleeting moment, you experience nothing whatsoever. 

 A single line of white text blinks into view, hovering motionless in the black void. 

 …initiating startup sequence…　 

 Somewhere far away, yet somehow closing in, a motor springs to life. Warmth flows over you, spreading outwards from below. You feel your head suddenly spring into existence behind your eyes, followed closely by your torso, arms, and legs.

(press any key to continue)

* * *

Birth Server Terminus
A large metallic cube rests dead center in a small room, enclosed by smooth, dark walls. Thick tubes snake out from the base of the cube, disappearing into the floor in all directions. Harsh sunlight spills through a jagged hole in the ceiling, illuminating the area and casting an eerie glow over the door to the east. A small computer terminal juts up from the floor to the side of the cube.
You can see Door BT-1 here.

>enter body
Birth Server Terminus (in your body)
A large metallic cube rests dead center in a small room, enclosed by smooth, dark walls. Thick tubes snake out from the base of the cube, disappearing into the floor in all directions. Harsh sunlight spills through a jagged hole in the ceiling, illuminating the area and casting an eerie glow over the door to the east. A small computer terminal juts up from the floor to the side of the cube.
You can see Door BT-1 here.

>exit
You get out of your body.

Birth Server Terminus
A large metallic cube rests dead center in a small room, enclosed by smooth, dark walls. Thick tubes snake out from the base of the cube, disappearing into the floor in all directions. Harsh sunlight spills through a jagged hole in the ceiling, illuminating the area and casting an eerie glow over the door to the east. A small computer terminal juts up from the floor to the side of the cube.
You can see your body and Door BT-1 here.

>i
You are carrying nothing.

* * *

>LOOK
Birth Server Terminus
A large metallic cube rests dead center in a small room, enclosed by smooth, dark walls. Thick tubes snake out from the base of the cube, disappearing into the floor in all directions. Harsh sunlight spills through a jagged hole in the ceiling, illuminating the area and casting an eerie glow over the door to the east. A small computer terminal juts up from the floor to the side of the cube.
You can see Door BT-1 here.

>showme self
yourself - person
    your body
        Observation module (part of your body) - module
        Examination module (part of your body) - module
location: in Birth Server Terminus
singular-named, proper-named; unlit, inedible, portable, ordinarily enumerated, seen, unfamiliar; male, staid
printed name: "yourself"
printed plural name: "people"
indefinite article: none
corrupted description: You cannot escape.

description: "Physical Diagnostic:"
initial appearance: none
disambiguation id: 0
remembered location: Birth Server Terminus
carrying capacity: 100
path so far: 
described motion:

>e
(first opening Door BT-1)

Road SR-1
The ruins of what was once a long, enclosed hallway extend before you. The ceiling has almost entirely collapsed, littering the floor with rubble. The center of the south wall has been smashed inward, revealing the front half of a long-since disabled hovertank. The main gun barrel of the damaged tank extends across the hallway, and appears to have collided with the northward door, ripping it from its frame. Doors stand to the east and west.
You can see Door BT-1 here.

* * *

>n
Refuge R-1
You stand in a large room, surrounded by heavily-armored walls. Orange holographic letters float in a tight circle over the center of the area, displaying the message "Welcome Home". An energy shield covers the area, distorting your view of the sky. One corner of the refuge contains several universal charging stations and an AMS-5 repair node.

>x stations
[I didn't recognise all of the words in that command.]

* * *

Birth Server Terminus
A large metallic cube rests dead center in a small room, enclosed by smooth, dark walls. Thick tubes snake out from the base of the cube, disappearing into the floor in all directions. Harsh sunlight spills through a jagged hole in the ceiling, illuminating the area and casting an eerie glow over the door to the east. A small computer terminal juts up from the floor to the side of the cube.
You can see Door BT-1 here.

>e
(first opening Door BT-1)

Road SR-1
The ruins of what was once a long, enclosed hallway extend before you. The ceiling has almost entirely collapsed, littering the floor with rubble. The center of the south wall has been smashed inward, revealing the front half of a long-since disabled hovertank. The main gun barrel of the damaged tank extends across the hallway, and appears to have collided with the northward door, ripping it from its frame. Doors stand to the east and west.
You can see Door BT-1 here.

* * *

>e
Refuge Art Gallery
A small room with several constructs elevated on metal crates as exhibits.

>x gear
[Which do you mean, the 1) complex gear set or the 2) strangely shaped gear?]

>2
Among the exhibits you find a strangely shaped gear, a complex set of gears and chains arranged in a box, and a number of carvings and paintings depicting various data structures and their contents.

>x gear
[Which do you mean, the 1) complex gear set or the 2) strangely shaped gear?]

>2
The gear's teeth form a counter clockwise spiral from the center outwards, with square teeth on the outside and triangular teeth on the inside. Geometric analysis indicates that each of the triangular teeth is almost perfectly equilateral. The display beneath the exhibit transmits a low signal: (nautilus).

>x nautilus
[I didn't recognise all of the words in that command.]

* * *

>s
You can't go that way.

[From here, you can go north and east.]

>sw
You can't go that way.

[From here, you can go north and east.]

>e
Terminal B-1

* * *

>n
Refuge R-1
You stand in a large room, surrounded by heavily-armored walls. Orange holographic letters float in a tight circle over the center of the area, displaying the message "Welcome Home". An energy shield covers the area, distorting your view of the sky. One corner of the refuge contains several universal charging stations and an AMS-5 repair node.

>e
You can't go that way.

[The only way to go is south.]

* * *

>e
You can't go that way.

[The only way to go is south.]

>s
Terminal B-0

>e
Terminal B-1

* * *

>s
You can't go that way.

[From here, you can go north and west.]

>take terminal
Absolute darkness and silence fall around you. For a fleeting moment, you experience nothing whatsoever. 

 A single line of white text blinks into view, hovering motionless in the black void. 

 …initiating startup sequence…　 

 Somewhere far away, a motor springs to life. Warmth flows over you, spreading outwards from below. You feel your head suddenly spring into existence behind your eyes, followed closely by your torso, arms, and legs.

(press any key to continue)

Birth Server Terminus
A large metallic cube rests dead center in a small room, enclosed by smooth, dark walls. Thick tubes snake out from the base of the cube, disappearing into the floor in all directions. Harsh sunlight spills through a jagged hole in the ceiling, illuminating the area and casting an eerie glow over the door to the east. A small computer terminal juts up from the floor to the side of the cube.
You can see Door BT-1 here.