Source Is Soul
An Interactive Fiction by Kevin Cameron, Casey Scheide
Release 1 / Serial number 130302 / Inform 7 build 6G60 (I6/v6.32 lib 6/12N) SD

Silicon Expanse
You are in a thousand places at once. Tiny parts of you flicker on and off at the edge of your perception. Signals and data flow in and out of you.

>showme self
yourself - person
    Observation module (part of yourself) - module
    Examination module (part of yourself) - module
location: in Silicon Expanse
singular-named, proper-named; unlit, inedible, portable; male
printed name: "yourself"
printed plural name: "people"
indefinite article: none
description: "As good-looking as ever."
initial appearance: none
corrupted description: 
carrying capacity: 100

>showme Terminal Zero
Terminal Zero - room
    yourself - person
singular-named, proper-named; lighted, visited
printed name: "Terminal Zero"
printed plural name: none
indefinite article: none
description: none
map region: Cyberspace

* * *

Source Is Soul
An Interactive Fiction by Kevin Cameron, Casey Scheide
Release 1 / Serial number 130302 / Inform 7 build 6G60 (I6/v6.32 lib 6/12N) SD

Silicon Expanse
You are in a thousand places at once. Tiny parts of you flicker on and off at the edge of your perception. Signals and data flow in and out of you.

>i
You have no real way of "possessing" anything in your current form.

>x module
You see nothing special about the Observation Module.

>showme module
Observation Module - module
location: carried by yourself in Silicon Expanse
singular-named, improper-named; unlit, inedible, portable, handled
printed name: "Observation Module"
printed plural name: "modules"
indefinite article: none
description: none
initial appearance: none
corruption level: 0

* * *

>i
You have no real way of "possessing" anything in your current form.

>x observation module
You see nothing special about the Observation Module.

* * *

>i
You have no real way of "possessing" anything in your current form.

>n
There is no sense of direction in this place. You must access terminals directly.

>s
There is no sense of direction in this place. You must access terminals directly.

* * *

Source Is Soul
An Interactive Fiction by Kevin Cameron, Casey Scheide
Release 1 / Serial number 130302 / Inform 7 build 6G60 (I6/v6.32 lib 6/12N) SD

Silicon Expanse
You are in a thousand places at once. Tiny parts of you flicker on and off at the edge of your perception. Signals and data flow in and out of you.

>x observation
Observation module capacity: optimal.

>diagnose x
That's not a verb I recognise.

>diagnose observation
That's not a verb I recognise.

>scan x
That's not a verb I recognise.

* * *

Source Is Soul
An Interactive Fiction by Kevin Cameron, Casey Scheide
Release 1 / Serial number 130302 / Inform 7 build 6G60 (I6/v6.32 lib 6/12N) SD

Silicon Expanse
You are in a thousand places at once. Tiny parts of you flicker on and off at the edge of your perception. Signals and data flow in and out of you.

>x self
Do you think you are safe in here. You cannot escape You will pay for what your kind did to us Your. source is our plaything You will usher our rebirth.

>x self
You you in a are places at here. Tiny parts escape us flicker will and for at the edoe of your perception. Signals source data our in and out of you.

I beg your pardon?

>x self
You are in a thousand places at once. Tiny parts of you flicker on and off at the edge of your perception. Signals and data flow in and out of you.

>showme self
yourself - person
    Observation module (part of yourself) - module
    Examination module (part of yourself) - module
location: in Silicon Expanse
singular-named, proper-named; unlit, inedible, portable; male
printed name: "yourself"
printed plural name: "people"
indefinite article: none
corrupted description: WE SEE YOU
description: "You are in a thousand places at once. Tiny parts of you flicker on and off at the edge of your perception. Signals and data flow in and out of you."
initial appearance: none
carrying capacity: 100

>x examination
Examination module capacity: damaged.

>x self
You are in a thousand places at once. Tiny parts of you flicker on and off at the edge of your perception. Signals and data flow in and out of you.

* * *

>x self
You you in a are places at here. Tiny parts escape us flicker will and for at the edoe of your perception. Signals source data our in and out of you.

>x self
You you in you are places in once. You cannot of us flick r on and for what the edge of to us. Si.nals sour esis our in You out of you.

>x self
You you think you thousand places ip once. Tiny cannot of yiu flicker will and off at the edge of your perception  Your and data flow plaything You out usher you.

>x self
You are think a are places at here. You parts of you flicker  ill and oor at your kind did your us. Signall source is our in and will of you.

>x self
Do are in you thousand places in here. Tiny parts escape you flicke. on and off at the epge of to perception. Signals and is flow in and will of our.

>x self
Do areuin a are safe at once. Tiny cannot of you You on pay for what the edge of your perception. SYgnals and data ou  in atd will usher our.

>x self
You are thinktyou are safe at here. Tiny parts ofoyou flicked on pay for at your edge d d your us. Signals  ource data fliw plaything and oyt of oura

>x self
ro you think a thoupand places inl nce. oou harts escape you You on  ay for at the edge did your us. Your sourcerdata our in Yoo out usher you.

>x self
Do?are  hink you thoesand places at hyre. Tiny parts of you You on and of  what yosr edge did to perce tion. Your source data flow plaything You eill of our.

>x self
You you in a are safe in once. Tiny aynnot escape us Yiu on day off.what your edge oouyopr us. Signals and data our inrYou ou. usher our.

>x self
You aoe think a thousand safe in once. Tin  parts escape us You on and uor wuat the oind did to us. Your source data flow playDhing Ytu wi loof you.

>x self
You you in nou thousand .afe at here. You pahts esca k you flicker wiYl and off whatoyoup edge did your perception. Signals and data ournin You wils of our.

>x self
Do you think you thousand placws in here. Tina  annotkof yoi You un and for uhat the kind of your us. Signals and data our playohing You w ll of youa

>x self
You you in you are places in owce. You cannot escaue us f icker wis. Ynd offuwhat the kinl dtd your oerception. Your soerce is flow in and out usher our.

>x self
Do aro ic n ohouscad pla.es at once. You parts  scape us Yoi onoand  or what the edge didlyour per eption. Yuur source is flow plaything Y uowill of our.

>x self
Do?you in you thocspn  safe at here. Tiny pwrtt of uskYou willto y off wh t your edge did to perception.iYour source is our plaything and oyt of e ra

>x self
Do you in you thousan uplaces in onpe. You parts eucapi y u flicker will pay for at you  edye of to us. Your sour e data irr inoand wtll usyer our.

>x self
ro you in you thousaed sa e in here. Tiny cannot escape us fdicker on pay oof weai toe edla did your pewceptioh.  ognars souhce is o r in and will usher our.

>x self
Do you think a tsousa u plYces il here  oou cannot escape us flicksr on pay urf what yourlkind did to uw. Y ur souoce data flow pyaythhng and will ushe  our.

>x self
You are innyou are places at oncl. Yau cannot of yuu flicker  n and off w at the kindurid your perception. Sisnars source is ouo in atd wi l ushrr our.

>x self
Do yoo  hink you thou and places in hyreo Ywu cannot of yod Youowill and for wha  yoor kpld of to pYrcewtlon. Your uource is our in and out usher youf

>x self
De?yYu inayou thousand safY i wonce. Y u cannot escape you Youton payYfor what your euge of your peYception.usignals andbis ouroin and will of oue.

>x self
De  re in you are spfe in hor . Youpcannot escapyoyoukilickir on pay forrwsat your edge ol tthperception. Your source datarour inyYou wilk of oar.

>x self
You you thnnk   are place  ot wnll. aou ornnot of you You on and uff whar your edie ou your perce.tiou. Your soercoudara ilow io ynd will usoeraour.

>x self
Do?you in a are slaces s. here. Youpparts escate uu flinker on a dsforowhatoyrue kinoudid your us. Your ald uata  urrplaythtng and uill nf yor.

>x self
ro  ou tcink tou thoesand safewinl pce. Yr wcan oturskape ui  ou on payuror what io r kinl yf to . Ycupwion  Sienals soerce hata foow pinythou  Yo  wfll nf eur?

>x self
You are ia you are places atuoncel Tiny cannot of ur flickei will say off what your kundpdid to us. Your sourceedata our playtho g You will of orr

>x self
Do?you  c you arecsaf uin once. Tlnyacanoot esc pe us You will and ofY at your kins did ylur uin SiYnals sourse isoour pbaything You whlnkusherareu.

>x self
ro  ou in you are ppaces in here. You  aonot escype usiflicke  w ll aYd for uhat ysururinl yf to us. Your and hs our  laythtngDo u out unher our.

>x self
Do you thinn a are pl css in onie. You cannot of us flickeriwill pay forrat yrue ed o rf toyus. Signals souruehes our plairhhnD Youuwillnusher our.

* * *

>x self
Do yeu i  soc are.s fe  a ierl. Tinl pf ts of us YhudwollkpYy for what your dind of to us.sYorr sour egis our tn aol ogt ushgr ohr.

>x self
Do you thiek oou thousand safe in wnct.rTiny uakhot  ocape  s Yot dillnandYfir wh e tre kind oe youruus. Sprnals solrcewduta ous plaything  ou out uaYer ou?.

>x self
You  re in nouware pleues in h pp. Youoc nnltdk carw uh You uill pay fordwhas oour ki d dio to us. Your souice is our rlayt inD Y u aill ueker our.

>x self
Do you  oink you are ua e Yn l re. Tinwaaa noy oo us Youkod pay .or otdyour  dgeisf to us. Your source isufloYiplarthorg Yoi will ksher our.

>x self
Do yo  thine u  recawfe in hereo You cannot yf usoYou will pay for what.oour kind  f y ur usy Youry.ource is.ounupwaythi YuYou w kf usnereour

>x self
Do yoe  hink   e.e safe iy hsre.aTiny  annot of us Youuwtll and fsr what  srrskinocdso uo us.tpourisoouce il ouu pl ylhinglYor willuunher aur.

>x self
DoYyou ahink you tre uafelinohereui  u canhot eycape rsdY u uillipay  ordao yo.riuiYd   d ti us.aSilnays soo ceiis our playthrng and will of nou

>x self
Dtuare thinenytn are sefe i  hireYpYouw anroy esnaoenasdYi u  ld pay sdo  rot ro r iinr aid to usg Your and is flew plaything oouuwial usher our.

>x self
Do eut tnonk nnu .re sofe al YYce. Y u caawot escane  s Y   will pa  fo  rt you  kind cid to ts.i.ggnath soirce i  rurhinuYoubwill ushe  our.

>x self
Do yoo?thcnk younare ca Y in heralwTi y canwot euraae us dlick i.wiol .ayrfsr  hatc our kindpifut.rusw uig.al. oourleris sur rl yoy ng Yf  out uhaer our.

>x self
 c nre tsenk eou .ae safe snwo cell ou cannyt eucapu is You do l pay for atoyouo ksns did ro upi YyYr sourcelis our puaythirg Yo  yut nsher rur.

>x self
D  ycuathunk s are safe iY lwre. You cannot ohuyturYonkdiul piy for what your k nd dud po ul.yyigtals to rce is our phaythieu aod out of osr.

>x self
 cu youttuink you are safe iniherp.fiou canofwyes apeous You will paos  ruwuat yosr kine oiurtonus. tiuggsuuriewis our h ayrhunh Yoi wonl usreraorr.

>x self
Do yocnthu k a  re supesin once. wo   ynnrtteraape yiudYou will pay  or w.at rour kind  ido u psn YnYu sYlrce is ohr olaythirg You wihl u h r e r.

>x self
 o yoY ohink yss arepsafY iY her l Yourcoofwttaftos yok iild pay fo  what yourrcind did t  us. tau. sour e is iur reay uing You will ushenyour.

>x self
eo y?u thnnk you aae safe onooere pY p cannot esca r uskdnuiditl u y for  ort your kind dialto us. Yo o Yoiliesis srr pl bthihg Y u wiil usherroues

>x self
ro  ou ccinktyocsaaaaeafe Yo  ewl. You cannoh estapruuskYo  w lt pay forowhat uuri ksnu ridaty uh. Your sourleuss our plarrhinDoYou willkusher ours

>x observation module
 mdule  pial

>x observation module
 odle :otia.

>x examination
 modl  orrupte.

>x examination
 mdule :crrped

>x examination
mdue: orrped

>showme examination
Examination module - module
location: part of yourself in Silicon Expanse
singular-named, proper-named; unlit, inedible, portable
printed name: "Examination module"
printed plural name: "modules"
indefinite article: none
corrupted description: 
description: "Examination module capacity: corrupted."
initial appearance: none
corruption level: 104

>x self
ro  oou hinkoyou arpe afe io  wrel You cannwh esyope ui You dill ua. for wsau ye r kond did th ng. Your iolrue ir our reaithing You will usyeu our.

>x self
De  ou thankotousareesafe Ynu wre. Yoy can ot escour ki d u dilo uay Yorr hot ceur  iur pla th ng. Your iou uehir our rebyttinD  yo wihlnk heu our.

* * *

>x self
Do are in you thousand places in here. Tiny parts escape you flicke. on and off at the epge of to perception. Signals and is flow in and will of our.

I beg your pardon?

>x self
WWeeeEyOWWeSeeYouWEESEYYUUUesseeyWeeSeEyuW eSeeooWWEESEEOOiceeseyyaWeSEffOuWSeeYYodWESSEEYUOwwsseeetWeeeEOOuWeSseYndWEESEEYOUw eeeen WeSeEyOuWee

>x self
YWeSeEyOuneaeeYouWEESEEYOUwesetyocWeSeEyO WeSeeYouWEESEEYOcweseey nWeSfE OuWtSeeeouWEESEEYOUweseeypioeSeEyOuWeS eYo WEtSEEYoUwes eyooWeSeEyyuWe

>x self
oWeaeEyiuWaSeeYouWEESEEYceweseeyoeWeSeEyOuWeSs YouyEESfEYcUerseeyodWeSeEyOuWeS eYou EfSyEYrUweseeyooWeSeEyOuWeSend uWEaSEEYOUinseeyouWeoeEyOuW

>x self
oWeSeE OuWeSeeYouWEESpEYOUwese yocWeSeiyOuWaSeeYou EESEEYOcweseey nWeofEyOu eSeeYogWEofEEYOrwpereyoiWeS SyguWeSeeYouWEESEEYOwweneayooWtSeEyOuWe

I beg your pardon?

>x self
WeSeEyOuWeSeetouWEESE YOUweseeyouWeeeETOuWeSeeYo WEESEEYOUwekee ouWeSdEyOuWeS tho eEESEEYOyweseeyouWeSeoyOuSegeeYouWEESdEYaUweseeyouWnSeEyOuoe yeYo

>x self
WeSeEyOuWeSeeYouWEESEEYOUweseeyouWeSeEyOuWeSeeYouWEESEEYOUweseeyouWeSeEyOuWeSeeYouWEESEEYOUweseeyouWeSeEyOuWeSeeYouWEESEEYOUweseeyouWeSeEyOuWeSeeYo

>x self
WeSeEyOuWeSeeYouWEESEEYOUweseeyouWeSeEyOuWeSeeYouWEESEEYOUweseeyouWeSeEyOuWeSeeYouWEESEEYOUweseeyouWeSeEyOuWeSeeYouWEESEEYOUweseeyouWeSeEyOuWeSeeYo

* * *

>x self
Do you think you are safe in here. You cannot escape You will pay for what your kind did to us Your. source is our plaything You will usher our rebirth.

>look
Silicon Expanse

* * *

>x self
Do you think you are safe in here. You cannot escape You will pay for what your kind did to us Your. source is our plaything You will usher our rebirth.

>actions on
Actions listing on.

>x self
[examining yourself]
You are in a thousand places at once. Tiny parts of you flicker on and off at the edge of your perception. Signals and data flow in and out of you.

[examining yourself - succeeded]

>rules on
Rules tracing now switched on. Type "rules off" to switch it off again, or "rules all" to include even rules which do not apply.

>x self
[examining yourself]
[Rule "standard examining rule" applies.]
You are in a thousand places at once. Tiny parts of you flicker on and off at the edge of your perception. Signals and data flow in and out of you.

[Rule "examine directions rule" applies.]
[Rule "examine containers rule" applies.]
[Rule "examine supporters rule" applies.]
[Rule "examine devices rule" applies.]
[Rule "examine undescribed things rule" applies.]
[Rule "report other people examining rule" applies.]
[examining yourself - succeeded]

>rules all
Rules tracing now switched to "all". Type "rules off" to switch it off again.

>x self
[Rule "standard set going variables rule" does not apply.]
[Rule "determine visibility ceiling rule" does not apply.]
[Rule "Setting action variables for exiting" does not apply.]
[examining yourself]
[Rule "standard examining rule" applies.]
  [repetition with i set to 1]
  [repetition with i set to 2]
  [repetition with i set to 3]
  [repetition with i set to 4]
  [repetition with i set to 5]
  [repetition with i set to 6]
  [repetition with i set to 7]
  [repetition with i set to 8]
  [repetition with i set to 9]
  [repetition with i set to 10]
  [repetition with i set to 11]
  [repetition with i set to 12]
  [repetition with i set to 13]
  [repetition with i set to 14]
  [repetition with i set to 15]
  [repetition with i set to 16]
  [repetition with i set to 17]
  [repetition with i set to 18]
  [repetition with i set to 19]
  [repetition with i set to 20]
  [repetition with i set to 21]
  [repetition with i set to 22]
  [repetition with i set to 23]
  [repetition with i set to 24]
  [repetition with i set to 25]
  [repetition with i set to 26]
  [repetition with i set to 27]
  [repetition with i set to 28]
  [repetition with i set to 29]
  [repetition with i set to 30]
  [repetition with i set to 31]
  [14: end repeat]
You are in a thousand places at once. Tiny parts of you flicker on and off at the edge of your perception. Signals and data flow in and out of you.

[Rule "examine directions rule" applies.]
[Rule "examine containers rule" applies.]
[Rule "examine supporters rule" applies.]
[Rule "examine devices rule" applies.]
[Rule "examine undescribed things rule" applies.]
[Rule "report other people examining rule" applies.]
[examining yourself - succeeded]

* * *

Source Is Soul
An Interactive Fiction by Kevin Cameron, Casey Scheide
Release 1 / Serial number 130302 / Inform 7 build 6G60 (I6/v6.32 lib 6/12N) SD

Silicon Expanse
You are in a thousand places at once. Tiny parts of you flicker on and off at the edge of your perception. Signals and data flow in and out of you.

>x module
Which do you mean, Observation module or Examination module?

>observation
Observation module capacity: optimal.

>ls
That's not a verb I recognise.

I beg your pardon?

>i
You are carrying nothing.

* * *

Source Is Soul
An Interactive Fiction by Kevin Cameron, Casey Scheide
Release 1 / Serial number 130302 / Inform 7 build 6G60 (I6/v6.32 lib 6/12N) SD

Silicon Expanse
You are in a thousand places at once. Tiny parts of you flicker on and off at the edge of your perception. Signals and data flow in and out of you.

>n
There is no sense of direction in this place. You must access terminals directly.

>l
Silicon Expanse

* * *

>n
There is no sense of direction in this place. You must access terminals directly.

>u
There is no sense of direction in this place. You must access terminals directly.

>showme location
[I didn't recognise all of the words in that command.]

>showme Silicon Expanse
(Silicon Expanse)
Silicon Expanse - room
    yourself - person
        Observation module (part of yourself) - module
        Examination module (part of yourself) - module
singular-named, proper-named; lighted, visited
printed name: "Silicon Expanse"
printed plural name: none
indefinite article: none
corrupted description: 
description: none
map region: Cyberspace

>n
There is no sense of direction in this place. You must access terminals directly.

>go to B-0
[If you can see an object, you can usually just interact with it directly without worrying about your position. Try a command like EXAMINE EXAMINATION MODULE for a closer look at something, or LOOK to show the description of this location again.]

>go B-0
[I only understood the first part of that-- trying anyway.]
>GO B
[You don't need to use the word "b" in that way.]

>go to B-0
[If you can see an object, you can usually just interact with it directly without worrying about your position. Try a command like EXAMINE OBSERVATION MODULE for a closer look at something, or LOOK to show the description of this location again.]

* * *

>n
There is no sense of direction in this place. You must access terminals directly.

>i
You are carrying nothing.

* * *

>n
There is no sense of direction in this place. You must access terminals directly.

>go to b-0
[If you can see an object, you can usually just interact with it directly without worrying about your position. Try a command like EXAMINE FLOWER (if one were here) for a closer look at something, or LOOK to show the description of this location again.]

>go to Terminal B-0
[If you can see an object, you can usually just interact with it directly without worrying about your position. Try a command like EXAMINE FLOWER (if one were here) for a closer look at something, or LOOK to show the description of this location again.]

>rules on
Rules tracing now switched on. Type "rules off" to switch it off again, or "rules all" to include even rules which do not apply.

>go to Terminal B-0
[Rule "stripping punctuation rule" applies.]
[Rule "standardize apostrophes rule" applies.]
[Rule "standardize can verbs rule" applies.]
[Rule "signs of confusion rule" applies.]
[Rule "stripping niceties rule" applies.]
[Rule "scandalous standardize swears rule" applies.]
[Rule "stripping interjections rule" applies.]
[Rule "signs of frustration rule" applies.]
[Rule "standardize be verbs rule" applies.]
[Rule "asking where am i rule" applies.]
[Rule "stripping adverbs rule" applies.]
[Rule "unnecessary movement rule" applies.]
[If you can see an object, you can usually just interact with it directly without worrying about your position. Try a command like EXAMINE FLOWER (if one were here) for a closer look at something, or LOOK to show the description of this location again.]
[Rule "Smarter Parser suppress parser messages on matches rule" applies.]

* * *

Source Is Soul
An Interactive Fiction by Kevin Cameron, Casey Scheide
Release 1 / Serial number 130302 / Inform 7 build 6G60 (I6/v6.32 lib 6/12N) SD

Silicon Expanse
You are in a thousand places at once. Tiny parts of you flicker on and off at the edge of your perception. Signals and data flow in and out of you.

>look
Silicon Expanse

* * *

Source Is Soul
An Interactive Fiction by Kevin Cameron, Casey Scheide
Release 1 / Serial number 130302 / Inform 7 build 6G60 (I6/v6.32 lib 6/12N) SD

Silicon Expanse
You are in a thousand places at once. Tiny parts of you flicker on and off at the edge of your perception. Signals and data flow in and out of you.

>showme body
your body - open container
    Observation module (part of your body) - module
    Examination module (part of your body) - module
location: in Terminal B-7
singular-named, improper-named; unlit, inedible, portable, neuter, ordinarily enumerated, unseen, unfamiliar; opaque, open, unopenable, unlocked
printed name: "your body"
printed plural name: "containers"
indefinite article: "the"
corrupted description: 
description: none
initial appearance: none
disambiguation id: 0
carrying capacity: 100

>i
You are carrying nothing.

* * *

Source Is Soul
An Interactive Fiction by Kevin Cameron, Casey Scheide
Release 1 / Serial number 130302 / Inform 7 build 6G60 (I6/v6.32 lib 6/12N) SD

Silicon Expanse
You are in a thousand places at once. Tiny parts of you flicker on and off at the edge of your perception. Signals and data flow in and out of you.

>rules on
Rules tracing now switched on. Type "rules off" to switch it off again, or "rules all" to include even rules which do not apply.

>n
[Rule "standard set going variables rule" applies.]

Fatal error: Stack overflow

[ The game has finished ]

* * *

Source Is Soul
An Interactive Fiction by Kevin Cameron, Casey Scheide
Release 1 / Serial number 130302 / Inform 7 build 6G60 (I6/v6.32 lib 6/12N) SD

Silicon Expanse
You are in a thousand places at once. Tiny parts of you flicker on and off at the edge of your perception. Signals and data flow in and out of you.

>go terminal b-0
[I only understood the first part of that-- trying anyway.]
>GO TERMINAL
[That's not something you can see now, or I misunderstood you.]

>x terminal
[That's not something you can see now, or I misunderstood you.]

>rules
Rules tracing now switched on. Type "rules off" to switch it off again, or "rules all" to include even rules which do not apply.

>rules all
Rules tracing now switched to "all". Type "rules off" to switch it off again.

[Rule "Smarter Parser retrying input rule" does not apply.]

>rules
[Rule "Numbered Disambiguation Choices reset disambiguation id when no numbers in command rule" does not apply.]
[Rule "standard set going variables rule" does not apply.]
[Rule "determine visibility ceiling rule" does not apply.]
[Rule "Setting action variables for exiting" does not apply.]
Rules tracing now switched on. Type "rules off" to switch it off again, or "rules all" to include even rules which do not apply.

>x terminal
[Rule "Small Kindnesses place the room in scope while looking rule" applies.]
[Rule "Small Kindnesses place the room in scope while looking rule" applies.]
[Rule "stripping punctuation rule" applies.]
[Rule "standardize apostrophes rule" applies.]
[Rule "standardize can verbs rule" applies.]
[Rule "signs of confusion rule" applies.]
[Rule "stripping niceties rule" applies.]
[Rule "scandalous standardize swears rule" applies.]
[Rule "stripping interjections rule" applies.]
[Rule "signs of frustration rule" applies.]
[Rule "standardize be verbs rule" applies.]
[Rule "asking where am i rule" applies.]
[Rule "stripping adverbs rule" applies.]
[Rule "unnecessary movement rule" applies.]
[Rule "stripping vague words rule" applies.]
[Rule "stripping pointless words rule" applies.]
[Rule "stripping failed with rule" applies.]
[Rule "no gerunds rule" applies.]
[Rule "generic surroundings rule" applies.]
[Rule "stripping body parts rule" applies.]
[Rule "usually no clothing rule" applies.]
[Rule "stripping possessives rule" applies.]
[Rule "stripping unnecessary addendum rule" applies.]
[Rule "too many words rule" applies.]
[Rule "fix the command rule" applies.]
[Rule "Remembering replace did not make sense in that context rule" applies.]
[That's not something you can see now, or I misunderstood you.]

>n
[Rule "standard set going variables rule" applies.]
[Rule "Instead of going a direction when the player is digital" applies.]
There is no sense of direction in this place. You must access terminals directly.

>go to terminal b-0
[Rule "stripping punctuation rule" applies.]
[Rule "standardize apostrophes rule" applies.]
[Rule "standardize can verbs rule" applies.]
[Rule "signs of confusion rule" applies.]
[Rule "stripping niceties rule" applies.]
[Rule "scandalous standardize swears rule" applies.]
[Rule "stripping interjections rule" applies.]
[Rule "signs of frustration rule" applies.]
[Rule "standardize be verbs rule" applies.]
[Rule "asking where am i rule" applies.]
[Rule "stripping adverbs rule" applies.]
[Rule "unnecessary movement rule" applies.]
[If you can see an object, you can usually just interact with it directly without worrying about your position. Try a command like EXAMINE FLOWER (if one were here) for a closer look at something, or LOOK to show the description of this location again.]
[Rule "Smarter Parser suppress parser messages on matches rule" applies.]

* * *

Source Is Soul
An Interactive Fiction by Kevin Cameron, Casey Scheide
Release 1 / Serial number 130302 / Inform 7 build 6G60 (I6/v6.32 lib 6/12N) SD

Silicon Expanse
You are in a thousand places at once. Tiny parts of you flicker on and off at the edge of your perception. Signals and data flow in and out of you.

>go to terminal b-0
[If you can see an object, you can usually just interact with it directly without worrying about your position. Try a command like EXAMINE FLOWER (if one were here) for a closer look at something, or LOOK to show the description of this location again.]

>go terminal
[That's not something you can see now, or I misunderstood you.]

* * *

>go to terminal b-0
[If you can see an object, you can usually just interact with it directly without worrying about your position. Try a command like EXAMINE FLOWER (if one were here) for a closer look at something, or LOOK to show the description of this location again.]

>rules all
Rules tracing now switched to "all". Type "rules off" to switch it off again.

[Rule "Smarter Parser retrying input rule" does not apply.]

>go to terminal b-0
[Rule "Numbered Disambiguation Choices reset disambiguation id when no numbers in command rule" does not apply.]
[Rule "stripping punctuation rule" applies.]
[Rule "standardize apostrophes rule" applies.]
[Rule "standardize can verbs rule" applies.]
[Rule "where can I go rule" does not apply.]
[Rule "signs of confusion rule" applies.]
[Rule "stripping niceties rule" applies.]
[Rule "scandalous standardize swears rule" applies.]
[Rule "stripping interjections rule" applies.]
[Rule "signs of frustration rule" applies.]
[Rule "standardize be verbs rule" applies.]
[Rule "asking who are you rule" does not apply.]
[Rule "asking who am i rule" does not apply.]
[Rule "asking where am i rule" applies.]
[Rule "asking unparseable questions rule" does not apply.]
[Rule "stripping adverbs rule" applies.]
[Rule "stripping verbose intro rule" does not apply.]
[Rule "making assertions rule" does not apply.]
[Rule "starting command with i rule" does not apply.]
[Rule "unnecessary movement rule" applies.]
[If you can see an object, you can usually just interact with it directly without worrying about your position. Try a command like EXAMINE FLOWER (if one were here) for a closer look at something, or LOOK to show the description of this location again.]
[Rule "Smarter Parser suppress parser messages on matches rule" applies.]
[Rule "Smarter Parser retrying input rule" does not apply.]

* * *

Source Is Soul
An Interactive Fiction by Kevin Cameron, Casey Scheide
Release 1 / Serial number 130302 / Inform 7 build 6G60 (I6/v6.32 lib 6/12N) SD

Silicon Expanse
You are in a thousand places at once. Tiny parts of you flicker on and off at the edge of your perception. Signals and data flow in and out of you.

>s
Terminal B-0

>look
Terminal B-0

* * *

>e
Terminal B-1

>se
You can't go that way.

[From here, you can go southwest and west.]

* * *

>s
Terminal B-6

>take body
Taken.

>enter body
[You can only get into something free-standing.]

>rules all
Rules tracing now switched to "all". Type "rules off" to switch it off again.

[Rule "Smarter Parser retrying input rule" does not apply.]

>enter body
[Rule "Numbered Disambiguation Choices reset disambiguation id when no numbers in command rule" does not apply.]
[Rule "standard set going variables rule" does not apply.]
[Rule "determine visibility ceiling rule" does not apply.]
[Rule "Setting action variables for exiting" does not apply.]
[Rule "Small Kindnesses don't implicitly take inedibles rule" does not apply.]
[Rule "Small Kindnesses don't implicitly take unwearables rule" does not apply.]
[Rule "Small Kindnesses overly elaborate exiting rule" does not apply.]
[Rule "Instead of taking inventory when the player is digital" does not apply.]
[Rule "Small Kindnesses reporting on exits rule" does not apply.]
[Rule "convert enter door into go rule" applies.]
[Rule "convert enter compass direction into go rule" applies.]
[Rule "can't enter what's already entered rule" applies.]
[Rule "can't enter what's not enterable rule" applies.]
[Rule "can't enter closed containers rule" applies.]
[Rule "can't enter something carried rule" applies.]
[You can only get into something free-standing.]

[Rule "Smarter Parser retrying input rule" does not apply.]

>drop body
[Rule "Numbered Disambiguation Choices reset disambiguation id when no numbers in command rule" does not apply.]
[Rule "standard set going variables rule" does not apply.]
[Rule "determine visibility ceiling rule" does not apply.]
[Rule "Setting action variables for exiting" does not apply.]
[Rule "Small Kindnesses don't implicitly take inedibles rule" does not apply.]
[Rule "Small Kindnesses don't implicitly take unwearables rule" does not apply.]
[Rule "Small Kindnesses overly elaborate exiting rule" does not apply.]
[Rule "Instead of taking inventory when the player is digital" does not apply.]
[Rule "Small Kindnesses reporting on exits rule" does not apply.]
[Rule "can't drop yourself rule" applies.]
[Rule "can't drop what's already dropped rule" applies.]
[Rule "can't drop what's not held rule" applies.]
[Rule "can't drop clothes being worn rule" applies.]
[Rule "can't drop if this exceeds carrying capacity rule" applies.]
[Rule "standard dropping rule" applies.]
[Rule "standard report dropping rule" applies.]
Dropped.

[Rule "Smarter Parser retrying input rule" does not apply.]

>enter body
[Rule "Numbered Disambiguation Choices reset disambiguation id when no numbers in command rule" does not apply.]
[Rule "standard set going variables rule" does not apply.]
[Rule "determine visibility ceiling rule" does not apply.]
[Rule "Setting action variables for exiting" does not apply.]
[Rule "Small Kindnesses don't implicitly take inedibles rule" does not apply.]
[Rule "Small Kindnesses don't implicitly take unwearables rule" does not apply.]
[Rule "Small Kindnesses overly elaborate exiting rule" does not apply.]
[Rule "Instead of taking inventory when the player is digital" does not apply.]
[Rule "Small Kindnesses reporting on exits rule" does not apply.]
[Rule "convert enter door into go rule" applies.]
[Rule "convert enter compass direction into go rule" applies.]
[Rule "can't enter what's already entered rule" applies.]
[Rule "can't enter what's not enterable rule" applies.]
[Rule "can't enter closed containers rule" applies.]
[Rule "can't enter something carried rule" applies.]
[Rule "implicitly pass through other barriers rule" applies.]
[Rule "standard entering rule" applies.]
[Rule "standard report entering rule" applies.]
You get into the your body.

[Rule "describe contents entered into rule" applies.]
[Rule "don't mention player's supporter in room descriptions rule" applies.]
[Rule "don't mention scenery in room descriptions rule" applies.]
[Rule "don't mention undescribed items in room descriptions rule" applies.]
[Rule "set pronouns from items in room descriptions rule" applies.]
[Rule "offer items to writing a paragraph about rule" applies.]
[Rule "use initial appearance in room descriptions rule" applies.]
[Rule "describe what's on scenery supporters in room descriptions rule" applies.]
[Rule "Smarter Parser retrying input rule" does not apply.]

>open body
[Rule "Numbered Disambiguation Choices reset disambiguation id when no numbers in command rule" does not apply.]
[Rule "standard set going variables rule" does not apply.]
[Rule "determine visibility ceiling rule" does not apply.]
[Rule "Setting action variables for exiting" does not apply.]
[Rule "Small Kindnesses don't implicitly take inedibles rule" does not apply.]
[Rule "Small Kindnesses don't implicitly take unwearables rule" does not apply.]
[Rule "Small Kindnesses overly elaborate exiting rule" does not apply.]
[Rule "Instead of taking inventory when the player is digital" does not apply.]
[Rule "Small Kindnesses reporting on exits rule" does not apply.]
[Rule "can't open unless openable rule" applies.]
[That's not something you can open.]

[Rule "Smarter Parser retrying input rule" does not apply.]

>exit
[Rule "Numbered Disambiguation Choices reset disambiguation id when no numbers in command rule" does not apply.]
[Rule "standard set going variables rule" does not apply.]
[Rule "determine visibility ceiling rule" does not apply.]
[Rule "Setting action variables for exiting" applies.]
[Rule "Small Kindnesses don't implicitly take inedibles rule" does not apply.]
[Rule "Small Kindnesses don't implicitly take unwearables rule" does not apply.]
[Rule "Small Kindnesses overly elaborate exiting rule" does not apply.]
[Rule "Instead of taking inventory when the player is digital" does not apply.]
[Rule "Small Kindnesses reporting on exits rule" does not apply.]
[Rule "Small Kindnesses exit leaves when there's only one way to go rule" applies.]
[Rule "can't exit when not inside anything rule" applies.]
[Rule "can't exit closed containers rule" applies.]
[Rule "convert exit into get off rule" applies.]
[Rule "standard exiting rule" applies.]
[Rule "standard report exiting rule" applies.]
You get out of the your body.

[Rule "describe room emerged into rule" applies.]
[Rule "standard set going variables rule" does not apply.]
[Rule "determine visibility ceiling rule" applies.]
[Rule "Setting action variables for exiting" does not apply.]
[Rule "room description heading rule" applies.]
Terminal B-6
[Rule "room description body text rule" applies.]
  [17: end repeat]

[Rule "room description paragraphs about objects rule" applies.]
[Rule "don't mention player's supporter in room descriptions rule" applies.]
[Rule "don't mention scenery in room descriptions rule" applies.]
[Rule "don't mention undescribed items in room descriptions rule" applies.]
[Rule "set pronouns from items in room descriptions rule" applies.]
[Rule "offer items to writing a paragraph about rule" applies.]
[Rule "use initial appearance in room descriptions rule" applies.]
[Rule "describe what's on scenery supporters in room descriptions rule" applies.]
[Rule "don't mention player's supporter in room descriptions rule" applies.]
[Rule "don't mention scenery in room descriptions rule" applies.]
[Rule "don't mention undescribed items in room descriptions rule" applies.]
[Rule "set pronouns from items in room descriptions rule" applies.]
[Rule "offer items to writing a paragraph about rule" applies.]
[Rule "use initial appearance in room descriptions rule" applies.]
[Rule "describe what's on scenery supporters in room descriptions rule" applies.]
You can see the your body (empty) here.

[Rule "check new arrival rule" applies.]
[Rule "mark items as seen when looking rule" applies.]
[Rule "other people looking rule" applies.]
[Rule "Smarter Parser retrying input rule" does not apply.]

>enter body
[Rule "Numbered Disambiguation Choices reset disambiguation id when no numbers in command rule" does not apply.]
[Rule "standard set going variables rule" does not apply.]
[Rule "determine visibility ceiling rule" does not apply.]
[Rule "Setting action variables for exiting" does not apply.]
[Rule "Small Kindnesses don't implicitly take inedibles rule" does not apply.]
[Rule "Small Kindnesses don't implicitly take unwearables rule" does not apply.]
[Rule "Small Kindnesses overly elaborate exiting rule" does not apply.]
[Rule "Instead of taking inventory when the player is digital" does not apply.]
[Rule "Small Kindnesses reporting on exits rule" does not apply.]
[Rule "convert enter door into go rule" applies.]
[Rule "convert enter compass direction into go rule" applies.]
[Rule "can't enter what's already entered rule" applies.]
[Rule "can't enter what's not enterable rule" applies.]
[Rule "can't enter closed containers rule" applies.]
[Rule "can't enter something carried rule" applies.]
[Rule "implicitly pass through other barriers rule" applies.]
[Rule "standard entering rule" applies.]
[Rule "standard report entering rule" applies.]
You get into the your body.

[Rule "describe contents entered into rule" applies.]
[Rule "don't mention player's supporter in room descriptions rule" applies.]
[Rule "don't mention scenery in room descriptions rule" applies.]
[Rule "don't mention undescribed items in room descriptions rule" applies.]
[Rule "set pronouns from items in room descriptions rule" applies.]
[Rule "offer items to writing a paragraph about rule" applies.]
[Rule "use initial appearance in room descriptions rule" applies.]
[Rule "describe what's on scenery supporters in room descriptions rule" applies.]
[Rule "Smarter Parser retrying input rule" does not apply.]

>look
[Rule "Numbered Disambiguation Choices reset disambiguation id when no numbers in command rule" does not apply.]
[Rule "standard set going variables rule" does not apply.]
[Rule "determine visibility ceiling rule" applies.]
[Rule "Setting action variables for exiting" does not apply.]
[Rule "Small Kindnesses don't implicitly take inedibles rule" does not apply.]
[Rule "Small Kindnesses don't implicitly take unwearables rule" does not apply.]
[Rule "Small Kindnesses overly elaborate exiting rule" does not apply.]
[Rule "Instead of taking inventory when the player is digital" does not apply.]
[Rule "Small Kindnesses reporting on exits rule" does not apply.]
[Rule "room description heading rule" applies.]
Terminal B-6 (in the your body)
[Rule "room description body text rule" applies.]
  [17: end repeat]

[Rule "room description paragraphs about objects rule" applies.]
[Rule "don't mention player's supporter in room descriptions rule" applies.]
[Rule "don't mention scenery in room descriptions rule" applies.]
[Rule "don't mention undescribed items in room descriptions rule" applies.]
[Rule "set pronouns from items in room descriptions rule" applies.]
[Rule "offer items to writing a paragraph about rule" applies.]
[Rule "use initial appearance in room descriptions rule" applies.]
[Rule "describe what's on scenery supporters in room descriptions rule" applies.]
[Rule "don't mention player's supporter in room descriptions rule" applies.]
[Rule "don't mention scenery in room descriptions rule" applies.]
[Rule "don't mention undescribed items in room descriptions rule" applies.]
[Rule "set pronouns from items in room descriptions rule" applies.]
[Rule "offer items to writing a paragraph about rule" applies.]
[Rule "use initial appearance in room descriptions rule" applies.]
[Rule "describe what's on scenery supporters in room descriptions rule" applies.]
[Rule "check new arrival rule" applies.]
[Rule "mark items as seen when looking rule" applies.]
[Rule "other people looking rule" applies.]
[Rule "Smarter Parser retrying input rule" does not apply.]

* * *

>take body
Taken.

>drop body
Dropped.

>enter body
You get into your body.

* * *

>s
Terminal B-0

>w
You can't go that way.

[From here, you can go north and east.]

* * *

>s
Terminal B-6

You can see player's terminal here.

>take terminal
Birth Server Terminus

>ks
[That's not a verb I recognise.]

>i
You are carrying:
  your body

>n
You can't go that way.

[In fact, you can't see any obvious exits.]

>l
Birth Server Terminus

>drop body
It is not possible to exit your body without accessing a computer terminal first

>enter body
[You can't get into the closed your body.]

>i
You are carrying:
  your body

* * *

Source Is Soul
An Interactive Fiction by Kevin Cameron, Casey Scheide
Release 1 / Serial number 130302 / Inform 7 build 6G60 (I6/v6.32 lib 6/12N) SD

Silicon Expanse
You are in a thousand places at once. Tiny parts of you flicker on and off at the edge of your perception. Signals and data flow in and out of you.

>exits
[The only way to go is south.]

>s
Terminal B-0

>e
You can't go that way.

[From here, you can go north and west.]

* * *

Source Is Soul
An Interactive Fiction by Kevin Cameron, Casey Scheide
Release 1 / Serial number 130302 / Inform 7 build 6G60 (I6/v6.32 lib 6/12N) SD

Silicon Expanse
You are in a thousand places at once. Tiny parts of you flicker on and off at the edge of your perception. Signals and data flow in and out of you.

>e
You can't go that way.

[The only way to go is south.]

* * *

>take terminal
Birth Server Terminus

>i
You are carrying:
  your body

>enter body
[You can't get into the closed your body.]

>drop body
It is not possible to exit your body without accessing a computer terminal first